-7,-8,-9,-10,-11,-12,-13,-14,-15,-16,-17,-18,-19,-19,-20,-20,-19,-20,-20,-20,-20,-20,-20,-20,-21,-21,-21,-20,-20,-20,-20,-19,-19,-18,-17,-16,-15,-14,-13,-12,-11,-10,-9,-8,-7,-6,-5,-4,-5,-6
-8,-9,-10,-11,-12,-13,-14,-15,-16,-17,-18,-19,-19,-19,-20,-21,-20,-20,-20,-21,-21,-21,-21,-20,-21,-21,-21,-21,-20,-20,-20,-19,-19,-18,-18,-17,-16,-15,-14,-13,-12,-11,-10,-9,-8,-7,-6,-5,-6,-7
-9,-10,-11,-12,-13,-14,-15,-16,-17,-18,-19,-20,-19,-20,-20,-21,-20,-20,-20,-20,-20,-21,-21,-21,-21,-22,-22,-21,-21,-20,-21,-20,-19,-19,-18,-18,-17,-16,-15,-14,-13,-12,-11,-10,-9,-8,-7,-6,-7,-8
-10,-11,-12,-13,-14,-15,-16,-17,-18,-19,-19,-20,-20,-20,-20,-20,-21,-21,-21,-21,-21,-22,-21,-21,-21,-22,-22,-21,-20,-21,-21,-20,-19,-20,-19,-19,-18,-17,-16,-15,-14,-13,-12,-11,-10,-9,-8,-7,-8,-9
-11,-12,-13,-14,-15,-16,-17,-18,-18,-19,-19,-20,-20,-20,-21,-21,-20,-21,-21,-21,-21,-21,-22,-22,-21,-22,-22,-21,-21,-21,-21,-21,-20,-20,-19,-19,-19,-18,-17,-16,-15,-14,-13,-12,-11,-10,-9,-8,-9,-10
-12,-13,-14,-15,-16,-17,-18,-18,-18,-19,-20,-21,-21,-21,-21,-22,-21,-22,-22,-22,-22,-22,-22,-22,-22,-23,-22,-21,-21,-21,-22,-21,-21,-21,-20,-20,-19,-19,-18,-17,-16,-15,-14,-13,-12,-11,-10,-9,-10,-11
-13,-14,-15,-16,-17,-18,-19,-18,-19,-19,-20,-21,-21,-21,-22,-21,-21,-22,-22,-21,-22,-22,-22,-22,-22,-23,-22,-22,-21,-22,-22,-22,-22,-21,-21,-20,-20,-20,-19,-18,-17,-16,-15,-14,-13,-12,-11,-10,-11,-12
-14,-15,-16,-17,-17,-18,-18,-18,-19,-20,-20,-20,-21,-21,-22,-22,-21,-22,-22,-22,-23,-22,-21,-22,-22,-22,-22,-22,-22,-23,-23,-23,-22,-21,-21,-20,-21,-20,-19,-19,-18,-17,-16,-15,-14,-13,-12,-11,-12,-13
-15,-16,-17,-18,-18,-18,-18,-18,-19,-20,-20,-21,-21,-21,-22,-21,-22,-21,-22,-22,-23,-23,-22,-23,-22,-21,-22,-22,-22,-23,-23,-23,-22,-21,-21,-21,-20,-20,-20,-19,-18,-18,-17,-16,-15,-14,-13,-12,-13,-14
-16,-17,-18,-18,-18,-19,-19,-19,-20,-20,-21,-21,-22,-21,-22,-22,-22,-22,-21,-22,-23,-22,-22,-22,-22,-21,-22,-22,-22,-22,-23,-22,-22,-22,-22,-22,-21,-20,-19,-19,-18,-18,-17,-17,-16,-15,-14,-13,-14,-15
-17,-18,-19,-18,-19,-19,-19,-20,-20,-21,-22,-21,-22,-21,-21,-21,-22,-21,-21,-22,-22,-23,-22,-22,-22,-22,-22,-23,-22,-23,-23,-23,-22,-21,-21,-21,-21,-20,-20,-19,-18,-18,-18,-18,-17,-16,-15,-14,-15,-16
-18,-18,-18,-19,-19,-19,-20,-20,-20,-21,-22,-21,-21,-22,-21,-22,-21,-22,-21,-22,-21,-22,-22,-22,-22,-22,-23,-23,-22,-23,-22,-23,-22,-21,-20,-20,-20,-20,-19,-19,-19,-19,-18,-18,-18,-17,-16,-15,-16,-17
-19,-19,-19,-19,-20,-20,-20,-21,-20,-21,-22,-22,-21,-22,-21,-21,-21,-22,-21,-21,-21,-21,-21,-22,-22,-22,-23,-22,-22,-22,-23,-23,-22,-22,-21,-20,-19,-20,-19,-18,-19,-19,-19,-18,-19,-18,-17,-16,-17,-18
-19,-20,-19,-20,-20,-20,-20,-21,-21,-21,-22,-22,-22,-22,-22,-21,-21,-22,-21,-21,-21,-21,-21,-21,-22,-21,-22,-23,-22,-23,-23,-23,-22,-22,-21,-20,-20,-19,-20,-19,-19,-19,-19,-19,-19,-19,-18,-17,-18,-18
-20,-19,-20,-19,-20,-19,-20,-21,-21,-20,-21,-21,-22,-22,-22,-21,-21,-22,-22,-21,-22,-21,-21,-22,-21,-22,-23,-22,-23,-23,-22,-22,-22,-21,-21,-21,-20,-20,-20,-19,-19,-18,-19,-19,-19,-19,-19,-18,-19,-19
-20,-20,-20,-20,-19,-20,-20,-20,-20,-19,-20,-21,-21,-22,-21,-21,-21,-21,-21,-22,-21,-21,-21,-21,-21,-21,-22,-21,-22,-22,-21,-21,-21,-21,-21,-21,-21,-20,-19,-19,-19,-18,-19,-19,-20,-20,-19,-19,-18,-19
-20,-20,-20,-20,-19,-19,-19,-19,-19,-19,-20,-20,-21,-21,-22,-22,-21,-20,-21,-21,-20,-21,-21,-20,-21,-21,-22,-22,-22,-21,-20,-21,-20,-20,-21,-20,-21,-20,-20,-20,-19,-19,-19,-19,-20,-20,-20,-20,-19,-19
-19,-19,-20,-19,-19,-18,-18,-19,-20,-19,-19,-20,-21,-20,-21,-21,-21,-21,-21,-20,-20,-20,-21,-20,-20,-21,-21,-21,-21,-20,-21,-20,-20,-21,-20,-20,-21,-21,-20,-19,-19,-19,-19,-20,-20,-21,-20,-20,-19,-19
-19,-20,-20,-19,-18,-19,-19,-19,-20,-19,-19,-20,-20,-21,-20,-20,-21,-20,-20,-20,-19,-20,-21,-21,-20,-21,-21,-20,-20,-19,-20,-19,-20,-21,-20,-20,-21,-20,-20,-19,-19,-19,-19,-19,-20,-20,-20,-20,-20,-20
-19,-19,-19,-19,-18,-19,-18,-19,-19,-19,-19,-20,-20,-21,-20,-20,-20,-21,-20,-21,-20,-20,-20,-20,-21,-20,-21,-20,-19,-18,-19,-20,-20,-21,-20,-20,-20,-20,-20,-19,-19,-19,-19,-19,-19,-20,-20,-20,-19,-19
-19,-19,-18,-19,-18,-19,-19,-19,-18,-19,-19,-19,-19,-20,-19,-20,-20,-21,-20,-21,-20,-20,-20,-21,-21,-20,-20,-19,-18,-19,-19,-19,-20,-20,-19,-20,-19,-20,-21,-20,-20,-20,-19,-19,-20,-20,-20,-20,-20,-19
-19,-19,-18,-18,-18,-18,-19,-19,-19,-19,-20,-20,-20,-20,-20,-20,-21,-20,-20,-20,-20,-21,-21,-20,-20,-20,-19,-19,-19,-19,-19,-19,-20,-19,-19,-19,-19,-20,-20,-20,-20,-20,-19,-19,-20,-19,-19,-19,-19,-19
-18,-19,-18,-18,-17,-17,-18,-18,-19,-19,-20,-19,-19,-19,-19,-19,-20,-21,-20,-19,-20,-20,-20,-19,-19,-20,-19,-19,-19,-19,-20,-19,-19,-19,-18,-18,-19,-20,-19,-20,-20,-20,-20,-20,-19,-19,-18,-18,-19,-18
-18,-19,-19,-18,-17,-17,-18,-18,-19,-19,-19,-18,-18,-19,-20,-19,-19,-20,-20,-20,-20,-20,-19,-20,-19,-19,-19,-19,-19,-19,-19,-18,-18,-19,-18,-18,-18,-19,-18,-19,-19,-20,-20,-19,-19,-19,-18,-18,-19,-18
-18,-18,-18,-17,-18,-17,-18,-18,-19,-19,-19,-18,-19,-18,-19,-19,-19,-19,-19,-19,-20,-19,-19,-19,-18,-18,-18,-18,-19,-19,-19,-19,-19,-18,-18,-18,-18,-18,-18,-18,-19,-19,-19,-19,-19,-20,-19,-19,-18,-18
-19,-18,-18,-18,-18,-18,-19,-19,-19,-19,-19,-18,-19,-18,-19,-19,-19,-19,-19,-19,-19,-19,-19,-18,-17,-18,-19,-18,-19,-19,-19,-18,-19,-19,-18,-18,-18,-17,-18,-18,-18,-19,-19,-18,-19,-19,-18,-18,-19,-18
-18,-19,-18,-18,-18,-18,-19,-19,-19,-19,-18,-18,-19,-19,-19,-20,-19,-18,-19,-18,-19,-19,-18,-18,-18,-17,-18,-18,-18,-18,-19,-19,-19,-19,-18,-17,-17,-17,-18,-17,-17,-18,-19,-19,-19,-18,-18,-18,-18,-18
-18,-18,-17,-18,-18,-18,-19,-18,-19,-19,-18,-17,-18,-19,-19,-20,-19,-18,-19,-18,-18,-18,-17,-17,-18,-17,-17,-18,-18,-18,-18,-19,-18,-18,-17,-18,-17,-17,-17,-17,-17,-17,-18,-19,-18,-18,-19,-18,-18,-18
-18,-17,-18,-18,-17,-18,-18,-18,-19,-18,-17,-17,-18,-18,-19,-19,-19,-19,-19,-18,-17,-18,-17,-18,-17,-17,-17,-18,-19,-18,-18,-18,-17,-17,-17,-17,-17,-17,-16,-17,-17,-18,-18,-19,-18,-18,-18,-17,-17,-17
-17,-17,-17,-17,-17,-17,-18,-18,-18,-18,-17,-17,-18,-18,-18,-18,-19,-19,-19,-18,-18,-17,-17,-18,-18,-18,-17,-17,-18,-17,-18,-17,-16,-16,-17,-17,-17,-17,-17,-17,-17,-18,-18,-18,-18,-17,-17,-17,-17,-18
-17,-17,-16,-16,-17,-16,-17,-18,-17,-18,-17,-17,-17,-18,-17,-18,-19,-18,-19,-18,-18,-17,-17,-18,-17,-18,-17,-18,-17,-18,-17,-18,-17,-16,-17,-16,-17,-17,-17,-17,-17,-18,-17,-17,-17,-16,-17,-17,-18,-17
-17,-16,-16,-16,-16,-16,-17,-18,-18,-17,-17,-17,-18,-18,-17,-17,-18,-18,-18,-18,-18,-17,-17,-18,-18,-18,-18,-17,-16,-17,-16,-17,-16,-16,-16,-16,-17,-17,-16,-16,-16,-17,-17,-17,-16,-16,-16,-17,-17,-17
-16,-16,-16,-16,-16,-16,-17,-18,-17,-16,-17,-17,-18,-18,-17,-17,-18,-18,-18,-17,-18,-17,-17,-17,-18,-18,-17,-17,-17,-16,-17,-17,-16,-16,-16,-16,-17,-17,-17,-16,-16,-16,-17,-16,-16,-16,-16,-16,-16,-16
-15,-16,-16,-16,-16,-17,-17,-17,-17,-17,-17,-17,-17,-17,-17,-17,-18,-17,-18,-18,-17,-17,-17,-17,-18,-17,-17,-16,-17,-17,-16,-17,-17,-16,-16,-17,-16,-17,-16,-15,-15,-15,-16,-16,-15,-15,-15,-15,-15,-15
-14,-15,-16,-16,-16,-17,-16,-17,-17,-16,-17,-16,-16,-17,-16,-17,-17,-17,-18,-17,-18,-17,-17,-17,-17,-17,-16,-16,-17,-16,-16,-16,-17,-16,-15,-16,-15,-16,-15,-15,-15,-15,-16,-15,-15,-14,-14,-14,-15,-15
-14,-15,-15,-15,-16,-16,-16,-17,-17,-16,-16,-16,-16,-16,-16,-16,-16,-17,-17,-18,-17,-17,-17,-16,-16,-16,-17,-17,-16,-17,-16,-15,-16,-15,-15,-15,-16,-15,-14,-14,-15,-15,-16,-15,-15,-14,-13,-13,-14,-15
-14,-14,-15,-15,-16,-16,-15,-16,-16,-16,-16,-16,-16,-16,-16,-15,-16,-17,-16,-17,-17,-17,-16,-17,-17,-17,-17,-17,-16,-16,-15,-15,-15,-14,-15,-16,-15,-14,-14,-14,-14,-14,-15,-14,-14,-13,-12,-12,-13,-14
-14,-13,-14,-15,-15,-15,-15,-15,-16,-17,-17,-16,-17,-16,-16,-16,-16,-16,-16,-17,-17,-17,-17,-17,-18,-18,-18,-17,-16,-15,-16,-16,-16,-15,-16,-15,-14,-13,-14,-14,-13,-14,-14,-13,-13,-12,-11,-11,-12,-13
-13,-12,-13,-14,-15,-15,-15,-14,-15,-16,-17,-17,-16,-17,-16,-16,-17,-17,-17,-18,-17,-17,-18,-17,-17,-17,-17,-16,-16,-16,-15,-16,-16,-15,-15,-14,-14,-14,-14,-13,-13,-13,-13,-12,-12,-11,-10,-10,-11,-12
-12,-13,-13,-13,-14,-15,-15,-15,-14,-15,-16,-17,-17,-16,-16,-17,-18,-17,-17,-17,-17,-16,-17,-17,-17,-17,-18,-17,-16,-16,-15,-16,-15,-14,-14,-14,-14,-13,-13,-12,-12,-12,-12,-11,-11,-10,-9,-9,-10,-11
-11,-12,-12,-12,-13,-14,-14,-15,-14,-14,-15,-16,-16,-16,-17,-17,-18,-18,-18,-18,-17,-17,-17,-17,-17,-17,-18,-18,-17,-16,-16,-16,-15,-14,-14,-14,-14,-13,-12,-12,-12,-11,-11,-10,-10,-10,-9,-8,-9,-10
-10,-11,-11,-12,-12,-13,-14,-15,-14,-14,-15,-16,-15,-16,-17,-18,-19,-18,-18,-17,-17,-17,-18,-18,-17,-17,-18,-17,-17,-17,-16,-15,-15,-14,-14,-13,-13,-13,-12,-12,-11,-11,-11,-10,-9,-9,-8,-7,-8,-9
-9,-10,-11,-11,-12,-12,-13,-14,-14,-14,-15,-16,-15,-16,-17,-18,-18,-18,-18,-17,-17,-18,-18,-18,-18,-18,-17,-17,-17,-17,-16,-16,-15,-14,-14,-13,-13,-12,-12,-12,-11,-10,-10,-9,-8,-8,-7,-6,-7,-8
-8,-9,-10,-11,-11,-12,-12,-13,-13,-14,-15,-15,-16,-16,-17,-18,-18,-18,-19,-18,-17,-17,-18,-18,-19,-18,-17,-17,-18,-18,-17,-17,-16,-15,-14,-13,-13,-12,-12,-11,-10,-9,-9,-8,-7,-7,-6,-5,-6,-7
-7,-8,-9,-10,-10,-11,-11,-12,-13,-14,-15,-15,-16,-16,-17,-18,-18,-18,-19,-19,-18,-18,-19,-18,-19,-18,-18,-18,-18,-18,-17,-17,-16,-15,-14,-14,-13,-12,-11,-10,-9,-9,-8,-7,-6,-6,-5,-4,-5,-6
-6,-7,-8,-9,-10,-10,-11,-11,-12,-13,-14,-15,-16,-17,-18,-19,-19,-19,-19,-19,-18,-18,-19,-19,-19,-19,-19,-18,-19,-18,-17,-17,-16,-15,-14,-13,-12,-11,-10,-10,-9,-8,-7,-6,-6,-5,-4,-3,-4,-5
-5,-6,-7,-8,-9,-9,-10,-11,-12,-13,-14,-15,-16,-17,-18,-19,-19,-19,-19,-19,-19,-19,-19,-19,-19,-20,-20,-19,-19,-18,-18,-17,-16,-15,-14,-13,-12,-11,-10,-9,-8,-8,-7,-6,-5,-4,-3,-2,-3,-4
-4,-5,-6,-7,-8,-9,-10,-11,-12,-13,-14,-15,-16,-17,-18,-18,-19,-19,-19,-20,-20,-20,-20,-20,-19,-20,-20,-20,-20,-19,-18,-17,-16,-15,-14,-13,-12,-11,-10,-9,-8,-7,-6,-5,-4,-3,-2,-1,-2,-3
-5,-6,-7,-8,-9,-10,-11,-12,-13,-14,-15,-16,-17,-18,-19,-19,-19,-20,-20,-19,-20,-19,-20,-20,-20,-20,-20,-20,-20,-20,-19,-18,-17,-16,-15,-14,-13,-12,-11,-10,-9,-8,-7,-6,-5,-4,-3,-2,-3,-4
-6,-7,-8,-9,-10,-11,-12,-13,-14,-15,-16,-17,-18,-19,-20,-20,-19,-20,-20,-19,-19,-19,-20,-20,-20,-21,-20,-20,-20,-21,-20,-19,-18,-17,-16,-15,-14,-13,-12,-11,-10,-9,-8,-7,-6,-5,-4,-3,-4,-5
